XXXXXXXXX
X H   * X
X X XXX X
X X X   X
X  *X X X
 *X  *  X
 XXX XX X
* X *   X
X   X X X
X XF  F X
X*X XXX X
XX * XX X
XXX  *  X